NO ./assets/textures/colorstone.xpm
SO ./assets/textures/redbrick.xpm
WE ./assets/textures/bluestone.xpm
EA ./assets/textures/wood.xpm

F 26,13,0
C 90,222,255

1111111111111111111111111111111111111111111111
100000000011000000000000100000000000000000011
10110000011100000000000010000000000000000011
1001000000000000000000001000000000000000011
111111111011000001110000000000001000000011
                    100000000011000010011
                   111101111111110111011
                  111101111111110111011
                 110000001101010111011
                100000000000000011011
               100000000000000011011
              110000011101010111111
             111101110111010101011
            111101110111010101011
           111101110111010101011
          111101110111010101011
         111101110111010101011
        111101110111010101011
       111101110111010101011
      111101110111010101011
     111101110111010101011
    111101110111010101011
   111101110111010101011
  111101110111010101011
 111101110111010101011
111101110111010100011
1110001100001100000011111111111111111111111111
11000000100W0001110000000001010000001111100001
1111001010101000000101001000000010101000000011
1000100010010101000000001010010000000101010101
1111111111111111111111111111111111111111111111