NO ./assets/textures/purplestone.xpm
SO ./assets/textures/eagle.xpm
WE ./assets/textures/greystone.xpm
EA ./assets/textures/mossy.xpm

F 79,0,45
C 45,250,0

111111111111111
100000000000001
100W001111111111111111
1000001000000011110001
1000000000110001110001
1000001001111000000001
1111111111111111111111